[level]
map = ..........
      .#####.##.
      .#...#..#.
      .#...####.
      .##.##....
      ..........

[.]
name = red

[#]
name = blue
