%%%%%%%%%%%%%%%%%%%%%%%%%%%%%%%%%%%%%%%%%%%%%%%%%%%%%%
%%.....%%%%.....%%%%.....%%%%.....%%%%.....%%%%.....%%
%%..#..%%%%.....%%%%.....%%%%.....%%%%.....%%%%.....%%
%%.....%%%%.....%%%%.....%%%%.....%%%%.....%%%%.....%%
%%%%%%%%%%%%%%%%%%%%%%%%%%%%%%%%%%%%%%%%%%%%%%%%%%%%%%
%%%%%%%%%%%%%%%%%%%%%%%%%%%%%%%%%%%%%%%%%%%%%%%%%%%%%%
%%.....%%%%.....%%%%.....%%%%.....%%%%.....%%%%.....%%
%%.....%%%%.....%%%%.....%%%%.....%%%%.....%%%%.....%%
%%.....%%%%.....%%%%.....%%%%.....%%%%.....%%%%.....%%
%%%%%%%%%%%%%%%%%%%%%%%%%%%%%%%%%%%%%%%%%%%%%%%%%%%%%%
%%%%%%%%%%%%%%%%%%%%%%%%%%%%%%%%%%%%%%%%%%%%%%%%%%%%%%
%%.....%%%%.....%%%%.....%%%%.....%%%%.....%%%%.....%%
%%.....%%%%.....%%%%.....%%%%.....%%%%.....%%%%.....%%
%%.....%%%%.....%%%%.....%%%%.....%%%%.....%%%%.....%%
%%%%%%%%%%%%%%%%%%%%%%%%%%%%%%%%%%%%%%%%%%%%%%%%%%%%%%
%%%%%%%%%%%%%%%%%%%%%%%%%%%%%%%%%%%%%%%%%%%%%%%%%%%%%%
%%.....%%%%.....%%%%.....%%%%.....%%%%.....%%%%.....%%
%%.....%%%%.....%%%%.....%%%%.....%%%%.....%%%%.....%%
%%.....%%%%.....%%%%.....%%%%.....%%%%.....%%%%.....%%
%%%%%%%%%%%%%%%%%%%%%%%%%%%%%%%%%%%%%%%%%%%%%%%%%%%%%%
%%%%%%%%%%%%%%%%%%%%%%%%%%%%%%%%%%%%%%%%%%%%%%%%%%%%%%
%%.....%%%%.....%%%%.....%%%%.....%%%%.....%%%%.....%%
%%.....%%%%.....%%%%.....%%%%.....%%%%.....%%%%.....%%
%%.....%%%%.....%%%%.....%%%%.....%%%%.....%%%%.....%%
%%%%%%%%%%%%%%%%%%%%%%%%%%%%%%%%%%%%%%%%%%%%%%%%%%%%%%
%%%%%%%%%%%%%%%%%%%%%%%%%%%%%%%%%%%%%%%%%%%%%%%%%%%%%%
%%.....%%%%.....%%%%.....%%%%.....%%%%.....%%%%.....%%
%%.....%%%%.....%%%%.....%%%%.....%%%%.....%%%%.....%%
%%.....%%%%.....%%%%.....%%%%.....%%%%.....%%%%.....%%
%%%%%%%%%%%%%%%%%%%%%%%%%%%%%%%%%%%%%%%%%%%%%%%%%%%%%%
%%%%%%%%%%%%%%%%%%%%%%%%%%%%%%%%%%%%%%%%%%%%%%%%%%%%%%
%%.....%%%%.....%%%%.....%%%%.....%%%%.....%%%%.....%%
%%.....%%%%.....%%%%.....%%%%.....%%%%.....%%%%.....%%
%%.....%%%%.....%%%%.....%%%%.....%%%%.....%%%%.....%%
%%%%%%%%%%%%%%%%%%%%%%%%%%%%%%%%%%%%%%%%%%%%%%%%%%%%%%