######################################################
#%.....%%%%.....%%%%.....%%%%.....%%%%.....%%%%.....%#
#%..#..%%%%.....%%%%.....%%%%.....%%%%.....%%%%.....%#
#%.....%%%%.....%%%%.....%%%%.....%%%%.....%%%%.....%#
#%%%%%%%%%%%%%%%%%%%%%%%%%%%%%%%%%%%%%%%%%%%%%%%%%%%%#
#%%%%%%%%%%%%%%%%%%%%%%%%%%%%%%%%%%%%%%%%%%%%%%%%%%%%#
#%.....%%%%.....%%%%.....%%%%.....%%%%.....%%%%.....%#
#%.....%%%%.....%%%%.....%%%%.....%%%%.....%%%%.....%#
#%.....%%%%.....%%%%.....%%%%.....%%%%.....%%%%.....%#
#%%%%%%%%%%%%%%%%%%%%%%%%%%%%%%%%%%%%%%%%%%%%%%%%%%%%#
#%%%%%%%%%%%%%%%%%%%%%%%%%%%%%%%%%%%%%%%%%%%%%%%%%%%%#
#%.....%%%%.....%%%%.....%%%%.....%%%%.....%%%%.....%#
#%.....%%%%.....%%%%.....%%%%.....%%%%.....%%%%.....%#
#%.....%%%%.....%%%%.....%%%%.....%%%%.....%%%%.....%#
#%%%%%%%%%%%%%%%%%%%%%%%%%%%%%%%%%%%%%%%%%%%%%%%%%%%%#
#%%%%%%%%%%%%%%%%%%%%%%%%%%%%%%%%%%%%%%%%%%%%%%%%%%%%#
#%.....%%%%.....%%%%.....%%%%.....%%%%.....%%%%.....%#
#%.....%%%%.....%%%%.....%%%%.....%%%%.....%%%%.....%#
#%.....%%%%.....%%%%.....%%%%.....%%%%.....%%%%.....%#
#%%%%%%%%%%%%%%%%%%%%%%%%%%%%%%%%%%%%%%%%%%%%%%%%%%%%#
#%%%%%%%%%%%%%%%%%%%%%%%%%%%%%%%%%%%%%%%%%%%%%%%%%%%%#
#%.....%%%%.....%%%%.....%%%%.....%%%%.....%%%%.....%#
#%.....%%%%.....%%%%.....%%%%.....%%%%.....%%%%.....%#
#%.....%%%%.....%%%%.....%%%%.....%%%%.....%%%%.....%#
#%%%%%%%%%%%%%%%%%%%%%%%%%%%%%%%%%%%%%%%%%%%%%%%%%%%%#
#%%%%%%%%%%%%%%%%%%%%%%%%%%%%%%%%%%%%%%%%%%%%%%%%%%%%#
#%.....%%%%.....%%%%.....%%%%.....%%%%.....%%%%.....%#
#%.....%%%%.....%%%%.....%%%%.....%%%%.....%%%%.....%#
#%.....%%%%.....%%%%.....%%%%.....%%%%.....%%%%.....%#
#%%%%%%%%%%%%%%%%%%%%%%%%%%%%%%%%%%%%%%%%%%%%%%%%%%%%#
#%%%%%%%%%%%%%%%%%%%%%%%%%%%%%%%%%%%%%%%%%%%%%%%%%%%%#
#%.....%%%%.....%%%%.....%%%%.....%%%%.....%%%%.....%#
#%.....%%%%.....%%%%.....%%%%.....%%%%.....%%%%.....%#
#%.....%%%%.....%%%%.....%%%%.....%%%%.....%%%%.....%#
######################################################